



=========================================   Другие полезные команды ==========================================

man ping 	вызов руководства по работе с программой, в данном случае, - ping
whatis …keyword 	отображает описание действий указанной программы
mkbootdisk –device /dev/fd0 `uname -r` 	создаёт загрузочный флоппи-диск
gpg -c file1 	шифрует файл file1 с помощью GNU Privacy Guard
gpg file1.gpg 	дешифрует файл file1 с помощью GNU Privacy Guard
wget -r www.example.com 	загружает рекурсивно содержимое сайта www.example.com
wget -c www.example.com/file.iso 	загрузить файл www.example.com/file.iso с возможностью остановки и продолжения
echo 'wget -c www.example.com/files.iso' | at 09:00 	начать закачку в указанное время
ldd /usr/bin/ssh 	вывести список библиотек, необходимых для работы ssh
alias hh='history' 	назначить алиас hh команде history
find . -maxdepth 1 -name *.jpg -print -exec convert 	Изменение размеров всех изображений в папке, передача утилите «convert» из ImageMagick для создания уменьшенных копий изображений (предварительный просмотр)
swapon /dev/hda3 	активировать swap-пространство, расположенное на разделе hda3
swapon /dev/hda2 /dev/hdb3 	активировать swap-пространства, расположенные на разделах hda2 и hdb3
Просмотр справки и руководства по программе


=============================   Манипуляции с текстом ======================================================

grep Aug /var/log/messages из файла '/var/log/messages' 	отобрать и вывести на стандартное устройство вывода строки, содержащие «Aug»

grep ^Aug /var/log/messages из файла '/var/log/messages' 	отобрать и вывести на стандартное устройство вывода строки, начинающиеся на «Aug»

grep [0-9] /var/log/messages из файла '/var/log/messages' 	отобрать и вывести на стандартное устройство вывода строки, содержащие цифры

grep Aug -R /var/log/* 	отобрать и вывести на стандартное устройство вывода строки, содержащие «Aug», во всех файлах, находящихся в директории /var/log и ниже

sed 's/stringa1/stringa2/g' example.txt 	в файле example.txt заменить «string1» на «string2», результат вывести на стандартное устройство вывода

sed '/^$/d' example.txt 	удалить пустые строки из файла example.txt

sed '/ *#/d; /^$/d' example.txt 	удалить пустые строки и комментарии из файла example.txt

echo 'esempio' | tr '[:lower:]' '[:upper:]' 	преобразовать символы из нижнего регистра в верхний

sed -e '1d' result.txt 	удалить первую строку из файла example.txt

sed -n '/string1/p' 	отобразить только строки содержашие «string1»

sed -e 's/ *$' example.txt |удалить пустые символы в в конце каждой строки | |sed -e 's/string1g' example.txt 	удалить строку «string1» из текста не изменяя всего остального

sed -n '1,8p;5q' example.txt 	взять из файла с первой по восьмую строки и из них вывести первые пять

sed -n '5p;5q' example.txt 	вывести пятую строку

sed -e 's/0*/0/g' example.txt 	заменить последовательность из любого количества нулей одним нулём

cat -n file1 	пронумеровать строки при выводе содержимого файла

cat example.txt | awk 'NR%2==1' 	при выводе содержимого файла, не выводить чётные строки файла

echo a b c | awk '{print $1}' 	вывести первую колонку. Разделение, по-умолчанию, по проблелу/пробелам или символу/символам табуляции

echo a b c | awk '{print $1,$3}' 	вывести первую и треью колонки. Разделение, по-умолчанию, по проблелу/пробелам или символу/символам табуляции

paste file1 file2 	объединить содержимое file1 и file2 в виде таблицы: строка 1 из file1 = строка 1 колонка 1-n, строка 1 из file2 = строка 1 колонка n+1-m

paste -d '+' file1 file2 	объединить содержимое file1 и file2 в виде таблицы с разделителем «+»

sort file1 file2 	отсортировать содержимое двух файлов

sort file1 file2 | uniq 	отсортировать содержимое двух файлов, не отображая повторов

sort file1 file2 | uniq -u 	отсортировать содержимое двух файлов, отображая только уникальные строки (строки, встречающиеся в 
обоих файлах, не выводятся на стандартное устройство вывода)

sort file1 file2 | uniq -d 	отсортировать содержимое двух файлов, отображая только повторяющиеся строки

comm -1 file1 file2 	сравнить содержимое двух файлов, не отображая строки принадлежащие файлу 'file1'

comm -2 file1 file2 	сравнить содержимое двух файлов, не отображая строки принадлежащие файлу 'file2'

comm -3 file1 file2 	сравнить содержимое двух файлов, удаляя строки встречающиеся в обоих файлах
Преобразование наборов символов и файловых форматов

dos2unix filedos.txt fileunix.txt 	конвертировать файл текстового формата из MSDOS в UNIX (разница в символах возврата каретки)
unix2dos fileunix.txt filedos.txt 	конвертировать файл текстового формата из UNIX в MSDOS (разница в символах возврата коретки)

recode ..HTML < page.txt > page.html 	конвертировать содержимое тестового файла page.txt в html-файл page.html

recode -l | more 	вывести список доступных форматов
